####################
#..................#
#..................#
#..................#
#..................#
#######+############
      #.#
      #.#############
      #.............#
      #############.#
                  #.#
                  #.#
                  #.#
      #############+#######
      #...................#                     ####################
      #...................#         ............+..................#
      #...................#         .           #..................#
      #...................+..........           #..................#
      #...................#                     #..................#
      #...................#                     ####################
      #####################