####################
#..................#
#..................#
#..................#
#..................#
#######+############
      #.#
      #.#############
      #.............#
      #############.#
                  #.#
                  #.#
                  #.#
      #############+#######
      #...................#
      #...................#
      #...................#
      #...................#
      #...................#
      #...................#
      #####################